1111111111
1000100011
10101m1011
1000110001
1011110111
1000000001
1110101011
1e00000001
1111111111
1111111111